pres_approve,pres_disapprove,pres_unsure_NA,president,year,month,pres_polling_margin,election_year,mean_pres_polling_margin
43,55,2,Donald Trump,2020,11,-12,yes,-9.6
46,52,0,Donald Trump,2020,10,-6,yes,-9.6
46,53,1,Donald Trump,2020,10,-7,yes,-9.6
44,55,1,Donald Trump,2020,10,-11,yes,-9.6
43,55,0,Donald Trump,2020,10,-12,yes,-9.6
38,60,2,Donald Trump,2018,11,-22,yes,-12.625
38,60,2,Donald Trump,2018,11,-22,yes,-12.625
43,53,4,Donald Trump,2018,11,-10,yes,-12.625
43,53,4,Donald Trump,2018,11,-10,yes,-12.625
38,56,6,Donald Trump,2018,11,-18,yes,-12.625
38,56,6,Donald Trump,2018,11,-18,yes,-12.625
40,54,6,Donald Trump,2018,11,-14,yes,-12.625
40,54,6,Donald Trump,2018,11,-14,yes,-12.625
40,54,6,Donald Trump,2018,10,-14,yes,-12.625
40,54,6,Donald Trump,2018,10,-14,yes,-12.625
44,50,6,Donald Trump,2018,10,-6,yes,-12.625
44,50,6,Donald Trump,2018,10,-6,yes,-12.625
44,51,5,Donald Trump,2018,10,-7,yes,-12.625
44,51,5,Donald Trump,2018,10,-7,yes,-12.625
43,53,4,Donald Trump,2018,10,-10,yes,-12.625
43,53,4,Donald Trump,2018,10,-10,yes,-12.625
57,40,3,Barack Obama,2016,11,17,yes,12.14035087719298
57,40,3,Barack Obama,2016,11,17,yes,12.14035087719298
57,39,4,Barack Obama,2016,11,18,yes,12.14035087719298
57,39,4,Barack Obama,2016,11,18,yes,12.14035087719298
57,39,4,Barack Obama,2016,11,18,yes,12.14035087719298
57,39,4,Barack Obama,2016,11,18,yes,12.14035087719298
56,40,4,Barack Obama,2016,11,16,yes,12.14035087719298
56,40,4,Barack Obama,2016,11,16,yes,12.14035087719298
56,40,4,Barack Obama,2016,11,16,yes,12.14035087719298
56,40,4,Barack Obama,2016,11,16,yes,12.14035087719298
55,42,3,Barack Obama,2016,11,13,yes,12.14035087719298
55,42,3,Barack Obama,2016,11,13,yes,12.14035087719298
55,42,3,Barack Obama,2016,11,13,yes,12.14035087719298
55,42,3,Barack Obama,2016,11,13,yes,12.14035087719298
56,42,2,Barack Obama,2016,11,14,yes,12.14035087719298
56,42,2,Barack Obama,2016,11,14,yes,12.14035087719298
57,40,3,Barack Obama,2016,11,17,yes,12.14035087719298
57,40,3,Barack Obama,2016,11,17,yes,12.14035087719298
56,41,3,Barack Obama,2016,11,15,yes,12.14035087719298
56,41,3,Barack Obama,2016,11,15,yes,12.14035087719298
58,40,2,Barack Obama,2016,11,18,yes,12.14035087719298
58,40,2,Barack Obama,2016,11,18,yes,12.14035087719298
56,42,2,Barack Obama,2016,11,14,yes,12.14035087719298
56,42,2,Barack Obama,2016,11,14,yes,12.14035087719298
56,41,3,Barack Obama,2016,11,15,yes,12.14035087719298
56,41,3,Barack Obama,2016,11,15,yes,12.14035087719298
56,40,4,Barack Obama,2016,11,16,yes,12.14035087719298
56,40,4,Barack Obama,2016,11,16,yes,12.14035087719298
57,40,3,Barack Obama,2016,11,17,yes,12.14035087719298
57,40,3,Barack Obama,2016,11,17,yes,12.14035087719298
57,40,3,Barack Obama,2016,11,17,yes,12.14035087719298
57,40,3,Barack Obama,2016,11,17,yes,12.14035087719298
57,41,2,Barack Obama,2016,11,16,yes,12.14035087719298
57,41,2,Barack Obama,2016,11,16,yes,12.14035087719298
57,40,3,Barack Obama,2016,11,17,yes,12.14035087719298
57,40,3,Barack Obama,2016,11,17,yes,12.14035087719298
58,40,2,Barack Obama,2016,11,18,yes,12.14035087719298
58,40,2,Barack Obama,2016,11,18,yes,12.14035087719298
56,42,2,Barack Obama,2016,11,14,yes,12.14035087719298
56,42,2,Barack Obama,2016,11,14,yes,12.14035087719298
56,42,2,Barack Obama,2016,11,14,yes,12.14035087719298
56,42,2,Barack Obama,2016,11,14,yes,12.14035087719298
56,42,8,Barack Obama,2016,11,14,yes,12.14035087719298
56,42,8,Barack Obama,2016,11,14,yes,12.14035087719298
56,41,3,Barack Obama,2016,11,15,yes,12.14035087719298
56,41,3,Barack Obama,2016,11,15,yes,12.14035087719298
53,44,3,Barack Obama,2016,11,9,yes,12.14035087719298
53,44,3,Barack Obama,2016,11,9,yes,12.14035087719298
51,46,3,Barack Obama,2016,11,5,yes,12.14035087719298
51,46,3,Barack Obama,2016,11,5,yes,12.14035087719298
49,48,3,Barack Obama,2016,11,1,yes,12.14035087719298
49,48,3,Barack Obama,2016,11,1,yes,12.14035087719298
51,47,4,Barack Obama,2016,11,4,yes,12.14035087719298
51,47,4,Barack Obama,2016,11,4,yes,12.14035087719298
53,45,2,Barack Obama,2016,10,8,yes,12.14035087719298
53,45,2,Barack Obama,2016,10,8,yes,12.14035087719298
54,44,2,Barack Obama,2016,10,10,yes,12.14035087719298
54,44,2,Barack Obama,2016,10,10,yes,12.14035087719298
55,43,2,Barack Obama,2016,10,12,yes,12.14035087719298
55,43,2,Barack Obama,2016,10,12,yes,12.14035087719298
53,44,3,Barack Obama,2016,10,9,yes,12.14035087719298
53,44,3,Barack Obama,2016,10,9,yes,12.14035087719298
54,43,3,Barack Obama,2016,10,11,yes,12.14035087719298
54,43,3,Barack Obama,2016,10,11,yes,12.14035087719298
53,44,3,Barack Obama,2016,10,9,yes,12.14035087719298
53,44,3,Barack Obama,2016,10,9,yes,12.14035087719298
52,44,4,Barack Obama,2016,10,8,yes,12.14035087719298
52,44,4,Barack Obama,2016,10,8,yes,12.14035087719298
52,46,2,Barack Obama,2016,10,6,yes,12.14035087719298
52,46,2,Barack Obama,2016,10,6,yes,12.14035087719298
54,43,3,Barack Obama,2016,10,11,yes,12.14035087719298
54,43,3,Barack Obama,2016,10,11,yes,12.14035087719298
56,41,3,Barack Obama,2016,10,15,yes,12.14035087719298
56,41,3,Barack Obama,2016,10,15,yes,12.14035087719298
57,40,3,Barack Obama,2016,10,17,yes,12.14035087719298
57,40,3,Barack Obama,2016,10,17,yes,12.14035087719298
55,42,3,Barack Obama,2016,10,13,yes,12.14035087719298
55,42,3,Barack Obama,2016,10,13,yes,12.14035087719298
55,42,3,Barack Obama,2016,10,13,yes,12.14035087719298
55,42,3,Barack Obama,2016,10,13,yes,12.14035087719298
53,44,3,Barack Obama,2016,10,9,yes,12.14035087719298
53,44,3,Barack Obama,2016,10,9,yes,12.14035087719298
54,43,3,Barack Obama,2016,10,11,yes,12.14035087719298
54,43,3,Barack Obama,2016,10,11,yes,12.14035087719298
54,43,3,Barack Obama,2016,10,11,yes,12.14035087719298
54,43,3,Barack Obama,2016,10,11,yes,12.14035087719298
55,41,4,Barack Obama,2016,10,14,yes,12.14035087719298
55,41,4,Barack Obama,2016,10,14,yes,12.14035087719298
54,42,4,Barack Obama,2016,10,12,yes,12.14035087719298
54,42,4,Barack Obama,2016,10,12,yes,12.14035087719298
53,43,4,Barack Obama,2016,10,10,yes,12.14035087719298
53,43,4,Barack Obama,2016,10,10,yes,12.14035087719298
53,42,5,Barack Obama,2016,10,11,yes,12.14035087719298
53,42,5,Barack Obama,2016,10,11,yes,12.14035087719298
54,42,4,Barack Obama,2016,10,12,yes,12.14035087719298
54,42,4,Barack Obama,2016,10,12,yes,12.14035087719298
55,42,3,Barack Obama,2016,10,13,yes,12.14035087719298
55,42,3,Barack Obama,2016,10,13,yes,12.14035087719298
53,44,3,Barack Obama,2016,10,9,yes,12.14035087719298
53,44,3,Barack Obama,2016,10,9,yes,12.14035087719298
52,46,2,Barack Obama,2016,10,6,yes,12.14035087719298
52,46,2,Barack Obama,2016,10,6,yes,12.14035087719298
51,46,3,Barack Obama,2016,10,5,yes,12.14035087719298
51,46,3,Barack Obama,2016,10,5,yes,12.14035087719298
51,45,4,Barack Obama,2016,10,6,yes,12.14035087719298
51,45,4,Barack Obama,2016,10,6,yes,12.14035087719298
54,43,3,Barack Obama,2016,10,11,yes,12.14035087719298
54,43,3,Barack Obama,2016,10,11,yes,12.14035087719298
54,43,3,Barack Obama,2016,10,11,yes,12.14035087719298
54,43,3,Barack Obama,2016,10,11,yes,12.14035087719298
54,43,3,Barack Obama,2016,10,11,yes,12.14035087719298
54,43,3,Barack Obama,2016,10,11,yes,12.14035087719298
52,45,3,Barack Obama,2016,10,7,yes,12.14035087719298
52,45,3,Barack Obama,2016,10,7,yes,12.14035087719298
45,50,5,Barack Obama,2014,11,-5,yes,-11.440677966101696
45,50,5,Barack Obama,2014,11,-5,yes,-11.440677966101696
44,51,5,Barack Obama,2014,11,-7,yes,-11.440677966101696
44,51,5,Barack Obama,2014,11,-7,yes,-11.440677966101696
43,53,4,Barack Obama,2014,11,-10,yes,-11.440677966101696
43,53,4,Barack Obama,2014,11,-10,yes,-11.440677966101696
41,54,5,Barack Obama,2014,11,-13,yes,-11.440677966101696
41,54,5,Barack Obama,2014,11,-13,yes,-11.440677966101696
44,52,4,Barack Obama,2014,11,-8,yes,-11.440677966101696
44,52,4,Barack Obama,2014,11,-8,yes,-11.440677966101696
43,52,5,Barack Obama,2014,11,-9,yes,-11.440677966101696
43,52,5,Barack Obama,2014,11,-9,yes,-11.440677966101696
43,52,5,Barack Obama,2014,11,-9,yes,-11.440677966101696
43,52,5,Barack Obama,2014,11,-9,yes,-11.440677966101696
42,54,4,Barack Obama,2014,11,-12,yes,-11.440677966101696
42,54,4,Barack Obama,2014,11,-12,yes,-11.440677966101696
41,55,4,Barack Obama,2014,11,-14,yes,-11.440677966101696
41,55,4,Barack Obama,2014,11,-14,yes,-11.440677966101696
41,54,5,Barack Obama,2014,11,-13,yes,-11.440677966101696
41,54,5,Barack Obama,2014,11,-13,yes,-11.440677966101696
42,53,5,Barack Obama,2014,11,-11,yes,-11.440677966101696
42,53,5,Barack Obama,2014,11,-11,yes,-11.440677966101696
42,52,6,Barack Obama,2014,11,-10,yes,-11.440677966101696
42,52,6,Barack Obama,2014,11,-10,yes,-11.440677966101696
43,51,6,Barack Obama,2014,11,-8,yes,-11.440677966101696
43,51,6,Barack Obama,2014,11,-8,yes,-11.440677966101696
44,51,5,Barack Obama,2014,11,-7,yes,-11.440677966101696
44,51,5,Barack Obama,2014,11,-7,yes,-11.440677966101696
44,51,5,Barack Obama,2014,11,-7,yes,-11.440677966101696
44,51,5,Barack Obama,2014,11,-7,yes,-11.440677966101696
42,53,5,Barack Obama,2014,11,-11,yes,-11.440677966101696
42,53,5,Barack Obama,2014,11,-11,yes,-11.440677966101696
42,52,6,Barack Obama,2014,11,-10,yes,-11.440677966101696
42,52,6,Barack Obama,2014,11,-10,yes,-11.440677966101696
41,53,6,Barack Obama,2014,11,-12,yes,-11.440677966101696
41,53,6,Barack Obama,2014,11,-12,yes,-11.440677966101696
42,52,6,Barack Obama,2014,11,-10,yes,-11.440677966101696
42,52,6,Barack Obama,2014,11,-10,yes,-11.440677966101696
39,56,5,Barack Obama,2014,11,-17,yes,-11.440677966101696
39,56,5,Barack Obama,2014,11,-17,yes,-11.440677966101696
40,55,5,Barack Obama,2014,11,-15,yes,-11.440677966101696
40,55,5,Barack Obama,2014,11,-15,yes,-11.440677966101696
39,56,5,Barack Obama,2014,11,-17,yes,-11.440677966101696
39,56,5,Barack Obama,2014,11,-17,yes,-11.440677966101696
40,55,5,Barack Obama,2014,11,-15,yes,-11.440677966101696
40,55,5,Barack Obama,2014,11,-15,yes,-11.440677966101696
41,54,5,Barack Obama,2014,11,-13,yes,-11.440677966101696
41,54,5,Barack Obama,2014,11,-13,yes,-11.440677966101696
41,53,6,Barack Obama,2014,11,-12,yes,-11.440677966101696
41,53,6,Barack Obama,2014,11,-12,yes,-11.440677966101696
43,51,6,Barack Obama,2014,11,-8,yes,-11.440677966101696
43,51,6,Barack Obama,2014,11,-8,yes,-11.440677966101696
42,53,5,Barack Obama,2014,11,-11,yes,-11.440677966101696
42,53,5,Barack Obama,2014,11,-11,yes,-11.440677966101696
41,54,5,Barack Obama,2014,11,-13,yes,-11.440677966101696
41,54,5,Barack Obama,2014,11,-13,yes,-11.440677966101696
40,54,6,Barack Obama,2014,11,-14,yes,-11.440677966101696
40,54,6,Barack Obama,2014,11,-14,yes,-11.440677966101696
41,54,5,Barack Obama,2014,10,-13,yes,-11.440677966101696
41,54,5,Barack Obama,2014,10,-13,yes,-11.440677966101696
43,52,5,Barack Obama,2014,10,-9,yes,-11.440677966101696
43,52,5,Barack Obama,2014,10,-9,yes,-11.440677966101696
42,53,5,Barack Obama,2014,10,-11,yes,-11.440677966101696
42,53,5,Barack Obama,2014,10,-11,yes,-11.440677966101696
42,53,5,Barack Obama,2014,10,-11,yes,-11.440677966101696
42,53,5,Barack Obama,2014,10,-11,yes,-11.440677966101696
42,52,6,Barack Obama,2014,10,-10,yes,-11.440677966101696
42,52,6,Barack Obama,2014,10,-10,yes,-11.440677966101696
43,52,5,Barack Obama,2014,10,-9,yes,-11.440677966101696
43,52,5,Barack Obama,2014,10,-9,yes,-11.440677966101696
43,53,4,Barack Obama,2014,10,-10,yes,-11.440677966101696
43,53,4,Barack Obama,2014,10,-10,yes,-11.440677966101696
42,54,4,Barack Obama,2014,10,-12,yes,-11.440677966101696
42,54,4,Barack Obama,2014,10,-12,yes,-11.440677966101696
40,54,6,Barack Obama,2014,10,-14,yes,-11.440677966101696
40,54,6,Barack Obama,2014,10,-14,yes,-11.440677966101696
41,54,5,Barack Obama,2014,10,-13,yes,-11.440677966101696
41,54,5,Barack Obama,2014,10,-13,yes,-11.440677966101696
40,54,6,Barack Obama,2014,10,-14,yes,-11.440677966101696
40,54,6,Barack Obama,2014,10,-14,yes,-11.440677966101696
40,55,5,Barack Obama,2014,10,-15,yes,-11.440677966101696
40,55,5,Barack Obama,2014,10,-15,yes,-11.440677966101696
40,55,5,Barack Obama,2014,10,-15,yes,-11.440677966101696
40,55,5,Barack Obama,2014,10,-15,yes,-11.440677966101696
42,53,5,Barack Obama,2014,10,-11,yes,-11.440677966101696
42,53,5,Barack Obama,2014,10,-11,yes,-11.440677966101696
43,51,6,Barack Obama,2014,10,-8,yes,-11.440677966101696
43,51,6,Barack Obama,2014,10,-8,yes,-11.440677966101696
42,52,6,Barack Obama,2014,10,-10,yes,-11.440677966101696
42,52,6,Barack Obama,2014,10,-10,yes,-11.440677966101696
40,55,5,Barack Obama,2014,10,-15,yes,-11.440677966101696
40,55,5,Barack Obama,2014,10,-15,yes,-11.440677966101696
41,54,5,Barack Obama,2014,10,-13,yes,-11.440677966101696
41,54,5,Barack Obama,2014,10,-13,yes,-11.440677966101696
42,53,5,Barack Obama,2014,10,-11,yes,-11.440677966101696
42,53,5,Barack Obama,2014,10,-11,yes,-11.440677966101696
42,54,4,Barack Obama,2014,10,-12,yes,-11.440677966101696
42,54,4,Barack Obama,2014,10,-12,yes,-11.440677966101696
39,57,4,Barack Obama,2014,10,-18,yes,-11.440677966101696
39,57,4,Barack Obama,2014,10,-18,yes,-11.440677966101696
39,56,5,Barack Obama,2014,10,-17,yes,-11.440677966101696
39,56,5,Barack Obama,2014,10,-17,yes,-11.440677966101696
40,55,5,Barack Obama,2014,10,-15,yes,-11.440677966101696
40,55,5,Barack Obama,2014,10,-15,yes,-11.440677966101696
44,51,5,Barack Obama,2014,10,-7,yes,-11.440677966101696
44,51,5,Barack Obama,2014,10,-7,yes,-11.440677966101696
44,50,6,Barack Obama,2014,10,-6,yes,-11.440677966101696
44,50,6,Barack Obama,2014,10,-6,yes,-11.440677966101696
44,50,6,Barack Obama,2014,10,-6,yes,-11.440677966101696
44,50,6,Barack Obama,2014,10,-6,yes,-11.440677966101696
42,53,5,Barack Obama,2014,10,-11,yes,-11.440677966101696
42,53,5,Barack Obama,2014,10,-11,yes,-11.440677966101696
41,55,4,Barack Obama,2014,10,-14,yes,-11.440677966101696
41,55,4,Barack Obama,2014,10,-14,yes,-11.440677966101696
42,54,4,Barack Obama,2014,10,-12,yes,-11.440677966101696
42,54,4,Barack Obama,2014,10,-12,yes,-11.440677966101696
42,54,4,Barack Obama,2014,10,-12,yes,-11.440677966101696
42,54,4,Barack Obama,2014,10,-12,yes,-11.440677966101696
50,43,7,Barack Obama,2012,11,7,yes,7.113207547169813
50,43,7,Barack Obama,2012,11,7,yes,7.113207547169813
51,43,6,Barack Obama,2012,11,8,yes,7.113207547169813
51,43,6,Barack Obama,2012,11,8,yes,7.113207547169813
49,45,6,Barack Obama,2012,11,4,yes,7.113207547169813
49,45,6,Barack Obama,2012,11,4,yes,7.113207547169813
51,42,7,Barack Obama,2012,11,9,yes,7.113207547169813
51,42,7,Barack Obama,2012,11,9,yes,7.113207547169813
51,41,8,Barack Obama,2012,11,10,yes,7.113207547169813
51,41,8,Barack Obama,2012,11,10,yes,7.113207547169813
53,39,8,Barack Obama,2012,11,14,yes,7.113207547169813
53,39,8,Barack Obama,2012,11,14,yes,7.113207547169813
51,40,9,Barack Obama,2012,11,11,yes,7.113207547169813
51,40,9,Barack Obama,2012,11,11,yes,7.113207547169813
50,42,8,Barack Obama,2012,11,8,yes,7.113207547169813
50,42,8,Barack Obama,2012,11,8,yes,7.113207547169813
50,42,8,Barack Obama,2012,11,8,yes,7.113207547169813
50,42,8,Barack Obama,2012,11,8,yes,7.113207547169813
51,43,6,Barack Obama,2012,11,8,yes,7.113207547169813
51,43,6,Barack Obama,2012,11,8,yes,7.113207547169813
53,42,5,Barack Obama,2012,11,11,yes,7.113207547169813
53,42,5,Barack Obama,2012,11,11,yes,7.113207547169813
52,41,7,Barack Obama,2012,11,11,yes,7.113207547169813
52,41,7,Barack Obama,2012,11,11,yes,7.113207547169813
53,40,7,Barack Obama,2012,11,13,yes,7.113207547169813
53,40,7,Barack Obama,2012,11,13,yes,7.113207547169813
52,41,7,Barack Obama,2012,11,11,yes,7.113207547169813
52,41,7,Barack Obama,2012,11,11,yes,7.113207547169813
52,42,6,Barack Obama,2012,11,10,yes,7.113207547169813
52,42,6,Barack Obama,2012,11,10,yes,7.113207547169813
52,41,7,Barack Obama,2012,11,11,yes,7.113207547169813
52,41,7,Barack Obama,2012,11,11,yes,7.113207547169813
53,40,7,Barack Obama,2012,11,13,yes,7.113207547169813
53,40,7,Barack Obama,2012,11,13,yes,7.113207547169813
52,41,7,Barack Obama,2012,11,11,yes,7.113207547169813
52,41,7,Barack Obama,2012,11,11,yes,7.113207547169813
52,42,6,Barack Obama,2012,11,10,yes,7.113207547169813
52,42,6,Barack Obama,2012,11,10,yes,7.113207547169813
51,43,6,Barack Obama,2012,11,8,yes,7.113207547169813
51,43,6,Barack Obama,2012,11,8,yes,7.113207547169813
52,42,6,Barack Obama,2012,11,10,yes,7.113207547169813
52,42,6,Barack Obama,2012,11,10,yes,7.113207547169813
49,45,6,Barack Obama,2012,11,4,yes,7.113207547169813
49,45,6,Barack Obama,2012,11,4,yes,7.113207547169813
49,44,7,Barack Obama,2012,11,5,yes,7.113207547169813
49,44,7,Barack Obama,2012,11,5,yes,7.113207547169813
50,44,6,Barack Obama,2012,11,6,yes,7.113207547169813
50,44,6,Barack Obama,2012,11,6,yes,7.113207547169813
52,44,6,Barack Obama,2012,11,8,yes,7.113207547169813
52,44,6,Barack Obama,2012,11,8,yes,7.113207547169813
52,45,7,Barack Obama,2012,11,7,yes,7.113207547169813
52,45,7,Barack Obama,2012,11,7,yes,7.113207547169813
51,44,5,Barack Obama,2012,10,7,yes,7.113207547169813
51,44,5,Barack Obama,2012,10,7,yes,7.113207547169813
48,48,4,Barack Obama,2012,10,0,yes,7.113207547169813
48,48,4,Barack Obama,2012,10,0,yes,7.113207547169813
46,49,5,Barack Obama,2012,10,-3,yes,7.113207547169813
46,49,5,Barack Obama,2012,10,-3,yes,7.113207547169813
48,47,5,Barack Obama,2012,10,1,yes,7.113207547169813
48,47,5,Barack Obama,2012,10,1,yes,7.113207547169813
51,44,5,Barack Obama,2012,10,7,yes,7.113207547169813
51,44,5,Barack Obama,2012,10,7,yes,7.113207547169813
53,42,5,Barack Obama,2012,10,11,yes,7.113207547169813
53,42,5,Barack Obama,2012,10,11,yes,7.113207547169813
51,45,4,Barack Obama,2012,10,6,yes,7.113207547169813
51,45,4,Barack Obama,2012,10,6,yes,7.113207547169813
49,46,5,Barack Obama,2012,10,3,yes,7.113207547169813
49,46,5,Barack Obama,2012,10,3,yes,7.113207547169813
49,45,6,Barack Obama,2012,10,4,yes,7.113207547169813
49,45,6,Barack Obama,2012,10,4,yes,7.113207547169813
49,46,5,Barack Obama,2012,10,3,yes,7.113207547169813
49,46,5,Barack Obama,2012,10,3,yes,7.113207547169813
50,46,4,Barack Obama,2012,10,4,yes,7.113207547169813
50,46,4,Barack Obama,2012,10,4,yes,7.113207547169813
50,44,6,Barack Obama,2012,10,6,yes,7.113207547169813
50,44,6,Barack Obama,2012,10,6,yes,7.113207547169813
49,45,6,Barack Obama,2012,10,4,yes,7.113207547169813
49,45,6,Barack Obama,2012,10,4,yes,7.113207547169813
49,45,6,Barack Obama,2012,10,4,yes,7.113207547169813
49,45,6,Barack Obama,2012,10,4,yes,7.113207547169813
48,47,5,Barack Obama,2012,10,1,yes,7.113207547169813
48,47,5,Barack Obama,2012,10,1,yes,7.113207547169813
48,46,6,Barack Obama,2012,10,2,yes,7.113207547169813
48,46,6,Barack Obama,2012,10,2,yes,7.113207547169813
50,44,6,Barack Obama,2012,10,6,yes,7.113207547169813
50,44,6,Barack Obama,2012,10,6,yes,7.113207547169813
52,43,5,Barack Obama,2012,10,9,yes,7.113207547169813
52,43,5,Barack Obama,2012,10,9,yes,7.113207547169813
53,42,5,Barack Obama,2012,10,11,yes,7.113207547169813
53,42,5,Barack Obama,2012,10,11,yes,7.113207547169813
53,42,5,Barack Obama,2012,10,11,yes,7.113207547169813
53,42,5,Barack Obama,2012,10,11,yes,7.113207547169813
51,44,5,Barack Obama,2012,10,7,yes,7.113207547169813
51,44,5,Barack Obama,2012,10,7,yes,7.113207547169813
48,46,6,Barack Obama,2012,10,2,yes,7.113207547169813
48,46,6,Barack Obama,2012,10,2,yes,7.113207547169813
50,45,5,Barack Obama,2012,10,5,yes,7.113207547169813
50,45,5,Barack Obama,2012,10,5,yes,7.113207547169813
52,43,5,Barack Obama,2012,10,9,yes,7.113207547169813
52,43,5,Barack Obama,2012,10,9,yes,7.113207547169813
54,42,4,Barack Obama,2012,10,12,yes,7.113207547169813
54,42,4,Barack Obama,2012,10,12,yes,7.113207547169813
50,44,6,Barack Obama,2012,10,6,yes,7.113207547169813
50,44,6,Barack Obama,2012,10,6,yes,7.113207547169813
48,45,7,Barack Obama,2012,10,3,yes,7.113207547169813
48,45,7,Barack Obama,2012,10,3,yes,7.113207547169813
47,45,8,Barack Obama,2010,11,2,yes,-2.3157894736842097
47,45,8,Barack Obama,2010,11,2,yes,-2.3157894736842097
46,46,8,Barack Obama,2010,11,0,yes,-2.3157894736842097
46,46,8,Barack Obama,2010,11,0,yes,-2.3157894736842097
45,47,8,Barack Obama,2010,11,-2,yes,-2.3157894736842097
45,47,8,Barack Obama,2010,11,-2,yes,-2.3157894736842097
44,48,8,Barack Obama,2010,11,-4,yes,-2.3157894736842097
44,48,8,Barack Obama,2010,11,-4,yes,-2.3157894736842097
44,48,8,Barack Obama,2010,11,-4,yes,-2.3157894736842097
44,48,8,Barack Obama,2010,11,-4,yes,-2.3157894736842097
44,47,9,Barack Obama,2010,11,-3,yes,-2.3157894736842097
44,47,9,Barack Obama,2010,11,-3,yes,-2.3157894736842097
46,46,8,Barack Obama,2010,11,0,yes,-2.3157894736842097
46,46,8,Barack Obama,2010,11,0,yes,-2.3157894736842097
47,46,7,Barack Obama,2010,11,1,yes,-2.3157894736842097
47,46,7,Barack Obama,2010,11,1,yes,-2.3157894736842097
46,47,7,Barack Obama,2010,11,-1,yes,-2.3157894736842097
46,47,7,Barack Obama,2010,11,-1,yes,-2.3157894736842097
45,48,7,Barack Obama,2010,11,-3,yes,-2.3157894736842097
45,48,7,Barack Obama,2010,11,-3,yes,-2.3157894736842097
46,47,7,Barack Obama,2010,11,-1,yes,-2.3157894736842097
46,47,7,Barack Obama,2010,11,-1,yes,-2.3157894736842097
48,45,7,Barack Obama,2010,11,3,yes,-2.3157894736842097
48,45,7,Barack Obama,2010,11,3,yes,-2.3157894736842097
48,45,7,Barack Obama,2010,11,3,yes,-2.3157894736842097
48,45,7,Barack Obama,2010,11,3,yes,-2.3157894736842097
45,47,8,Barack Obama,2010,11,-2,yes,-2.3157894736842097
45,47,8,Barack Obama,2010,11,-2,yes,-2.3157894736842097
43,49,8,Barack Obama,2010,11,-6,yes,-2.3157894736842097
43,49,8,Barack Obama,2010,11,-6,yes,-2.3157894736842097
42,49,9,Barack Obama,2010,11,-7,yes,-2.3157894736842097
42,49,9,Barack Obama,2010,11,-7,yes,-2.3157894736842097
43,49,8,Barack Obama,2010,11,-6,yes,-2.3157894736842097
43,49,8,Barack Obama,2010,11,-6,yes,-2.3157894736842097
44,48,8,Barack Obama,2010,11,-4,yes,-2.3157894736842097
44,48,8,Barack Obama,2010,11,-4,yes,-2.3157894736842097
44,48,8,Barack Obama,2010,11,-4,yes,-2.3157894736842097
44,48,8,Barack Obama,2010,11,-4,yes,-2.3157894736842097
46,46,8,Barack Obama,2010,11,0,yes,-2.3157894736842097
46,46,8,Barack Obama,2010,11,0,yes,-2.3157894736842097
47,46,7,Barack Obama,2010,11,1,yes,-2.3157894736842097
47,46,7,Barack Obama,2010,11,1,yes,-2.3157894736842097
47,45,8,Barack Obama,2010,11,2,yes,-2.3157894736842097
47,45,8,Barack Obama,2010,11,2,yes,-2.3157894736842097
45,47,8,Barack Obama,2010,11,-2,yes,-2.3157894736842097
45,47,8,Barack Obama,2010,11,-2,yes,-2.3157894736842097
44,48,8,Barack Obama,2010,11,-4,yes,-2.3157894736842097
44,48,8,Barack Obama,2010,11,-4,yes,-2.3157894736842097
44,49,7,Barack Obama,2010,11,-5,yes,-2.3157894736842097
44,49,7,Barack Obama,2010,11,-5,yes,-2.3157894736842097
43,49,8,Barack Obama,2010,11,-6,yes,-2.3157894736842097
43,49,8,Barack Obama,2010,11,-6,yes,-2.3157894736842097
44,48,8,Barack Obama,2010,11,-4,yes,-2.3157894736842097
44,48,8,Barack Obama,2010,11,-4,yes,-2.3157894736842097
45,47,8,Barack Obama,2010,10,-2,yes,-2.3157894736842097
45,47,8,Barack Obama,2010,10,-2,yes,-2.3157894736842097
47,47,6,Barack Obama,2010,10,0,yes,-2.3157894736842097
47,47,6,Barack Obama,2010,10,0,yes,-2.3157894736842097
46,48,6,Barack Obama,2010,10,-2,yes,-2.3157894736842097
46,48,6,Barack Obama,2010,10,-2,yes,-2.3157894736842097
46,48,6,Barack Obama,2010,10,-2,yes,-2.3157894736842097
46,48,6,Barack Obama,2010,10,-2,yes,-2.3157894736842097
44,49,7,Barack Obama,2010,10,-5,yes,-2.3157894736842097
44,49,7,Barack Obama,2010,10,-5,yes,-2.3157894736842097
44,48,8,Barack Obama,2010,10,-4,yes,-2.3157894736842097
44,48,8,Barack Obama,2010,10,-4,yes,-2.3157894736842097
43,49,8,Barack Obama,2010,10,-6,yes,-2.3157894736842097
43,49,8,Barack Obama,2010,10,-6,yes,-2.3157894736842097
43,48,9,Barack Obama,2010,10,-5,yes,-2.3157894736842097
43,48,9,Barack Obama,2010,10,-5,yes,-2.3157894736842097
41,50,9,Barack Obama,2010,10,-9,yes,-2.3157894736842097
41,50,9,Barack Obama,2010,10,-9,yes,-2.3157894736842097
43,48,9,Barack Obama,2010,10,-5,yes,-2.3157894736842097
43,48,9,Barack Obama,2010,10,-5,yes,-2.3157894736842097
42,50,8,Barack Obama,2010,10,-8,yes,-2.3157894736842097
42,50,8,Barack Obama,2010,10,-8,yes,-2.3157894736842097
46,46,8,Barack Obama,2010,10,0,yes,-2.3157894736842097
46,46,8,Barack Obama,2010,10,0,yes,-2.3157894736842097
46,46,8,Barack Obama,2010,10,0,yes,-2.3157894736842097
46,46,8,Barack Obama,2010,10,0,yes,-2.3157894736842097
48,44,8,Barack Obama,2010,10,4,yes,-2.3157894736842097
48,44,8,Barack Obama,2010,10,4,yes,-2.3157894736842097
46,46,8,Barack Obama,2010,10,0,yes,-2.3157894736842097
46,46,8,Barack Obama,2010,10,0,yes,-2.3157894736842097
44,48,8,Barack Obama,2010,10,-4,yes,-2.3157894736842097
44,48,8,Barack Obama,2010,10,-4,yes,-2.3157894736842097
43,48,9,Barack Obama,2010,10,-5,yes,-2.3157894736842097
43,48,9,Barack Obama,2010,10,-5,yes,-2.3157894736842097
44,48,8,Barack Obama,2010,10,-4,yes,-2.3157894736842097
44,48,8,Barack Obama,2010,10,-4,yes,-2.3157894736842097
45,47,8,Barack Obama,2010,10,-2,yes,-2.3157894736842097
45,47,8,Barack Obama,2010,10,-2,yes,-2.3157894736842097
45,48,7,Barack Obama,2010,10,-3,yes,-2.3157894736842097
45,48,7,Barack Obama,2010,10,-3,yes,-2.3157894736842097
46,47,7,Barack Obama,2010,10,-1,yes,-2.3157894736842097
46,47,7,Barack Obama,2010,10,-1,yes,-2.3157894736842097
46,48,6,Barack Obama,2010,10,-2,yes,-2.3157894736842097
46,48,6,Barack Obama,2010,10,-2,yes,-2.3157894736842097
48,46,6,Barack Obama,2010,10,2,yes,-2.3157894736842097
48,46,6,Barack Obama,2010,10,2,yes,-2.3157894736842097
47,46,7,Barack Obama,2010,10,1,yes,-2.3157894736842097
47,46,7,Barack Obama,2010,10,1,yes,-2.3157894736842097
46,48,6,Barack Obama,2010,10,-2,yes,-2.3157894736842097
46,48,6,Barack Obama,2010,10,-2,yes,-2.3157894736842097
43,50,7,Barack Obama,2010,10,-7,yes,-2.3157894736842097
43,50,7,Barack Obama,2010,10,-7,yes,-2.3157894736842097
45,48,7,Barack Obama,2010,10,-3,yes,-2.3157894736842097
45,48,7,Barack Obama,2010,10,-3,yes,-2.3157894736842097
46,48,6,Barack Obama,2010,10,-2,yes,-2.3157894736842097
46,48,6,Barack Obama,2010,10,-2,yes,-2.3157894736842097
46,46,8,Barack Obama,2010,10,0,yes,-2.3157894736842097
46,46,8,Barack Obama,2010,10,0,yes,-2.3157894736842097
46,46,8,Barack Obama,2010,10,0,yes,-2.3157894736842097
46,46,8,Barack Obama,2010,10,0,yes,-2.3157894736842097
29,66,4,George W. Bush,2008,11,-37,yes,-41.333333333333336
29,66,4,George W. Bush,2008,11,-37,yes,-41.333333333333336
28,68,5,George W. Bush,2008,11,-40,yes,-41.333333333333336
28,68,5,George W. Bush,2008,11,-40,yes,-41.333333333333336
25,70,5,George W. Bush,2008,11,-45,yes,-41.333333333333336
25,70,5,George W. Bush,2008,11,-45,yes,-41.333333333333336
31,66,3,George W. Bush,2008,10,-35,yes,-41.333333333333336
31,66,3,George W. Bush,2008,10,-35,yes,-41.333333333333336
25,71,4,George W. Bush,2008,10,-46,yes,-41.333333333333336
25,71,4,George W. Bush,2008,10,-46,yes,-41.333333333333336
25,70,6,George W. Bush,2008,10,-45,yes,-41.333333333333336
25,70,6,George W. Bush,2008,10,-45,yes,-41.333333333333336
33,62,4,George W. Bush,2006,11,-29,yes,-22
33,62,4,George W. Bush,2006,11,-29,yes,-22
38,56,6,George W. Bush,2006,11,-18,yes,-22
38,56,6,George W. Bush,2006,11,-18,yes,-22
37,58,4,George W. Bush,2006,10,-21,yes,-22
37,58,4,George W. Bush,2006,10,-21,yes,-22
37,57,6,George W. Bush,2006,10,-20,yes,-22
37,57,6,George W. Bush,2006,10,-20,yes,-22
37,59,4,George W. Bush,2006,10,-22,yes,-22
37,59,4,George W. Bush,2006,10,-22,yes,-22
53,44,2,George W. Bush,2004,11,9,yes,2.5714285714285716
53,44,2,George W. Bush,2004,11,9,yes,2.5714285714285716
47,47,4,George W. Bush,2004,10,0,yes,2.5714285714285716
47,47,4,George W. Bush,2004,10,0,yes,2.5714285714285716
50,46,3,George W. Bush,2004,10,4,yes,2.5714285714285716
50,46,3,George W. Bush,2004,10,4,yes,2.5714285714285716
51,46,2,George W. Bush,2004,10,5,yes,2.5714285714285716
51,46,2,George W. Bush,2004,10,5,yes,2.5714285714285716
48,48,2,George W. Bush,2004,10,0,yes,2.5714285714285716
48,48,2,George W. Bush,2004,10,0,yes,2.5714285714285716
47,48,3,George W. Bush,2004,10,-1,yes,2.5714285714285716
47,48,3,George W. Bush,2004,10,-1,yes,2.5714285714285716
49,48,1,George W. Bush,2004,10,1,yes,2.5714285714285716
49,48,1,George W. Bush,2004,10,1,yes,2.5714285714285716
66,25,7,George W. Bush,2002,11,41,yes,37.833333333333336
66,25,7,George W. Bush,2002,11,41,yes,37.833333333333336
68,26,4,George W. Bush,2002,11,42,yes,37.833333333333336
68,26,4,George W. Bush,2002,11,42,yes,37.833333333333336
63,29,7,George W. Bush,2002,11,34,yes,37.833333333333336
63,29,7,George W. Bush,2002,11,34,yes,37.833333333333336
66,28,4,George W. Bush,2002,10,38,yes,37.833333333333336
66,28,4,George W. Bush,2002,10,38,yes,37.833333333333336
62,30,6,George W. Bush,2002,10,32,yes,37.833333333333336
62,30,6,George W. Bush,2002,10,32,yes,37.833333333333336
67,27,4,George W. Bush,2002,10,40,yes,37.833333333333336
67,27,4,George W. Bush,2002,10,40,yes,37.833333333333336
63,32,4,William J. Clinton,2000,11,31,yes,23.666666666666668
63,32,4,William J. Clinton,2000,11,31,yes,23.666666666666668
56,38,5,William J. Clinton,2000,10,18,yes,23.666666666666668
56,38,5,William J. Clinton,2000,10,18,yes,23.666666666666668
58,36,4,William J. Clinton,2000,10,22,yes,23.666666666666668
58,36,4,William J. Clinton,2000,10,22,yes,23.666666666666668
65,30,4,William J. Clinton,1998,11,35,yes,33.666666666666664
65,30,4,William J. Clinton,1998,11,35,yes,33.666666666666664
65,31,3,William J. Clinton,1998,11,34,yes,33.666666666666664
65,31,3,William J. Clinton,1998,11,34,yes,33.666666666666664
65,30,3,William J. Clinton,1998,11,35,yes,33.666666666666664
65,30,3,William J. Clinton,1998,11,35,yes,33.666666666666664
65,31,2,William J. Clinton,1998,10,34,yes,33.666666666666664
65,31,2,William J. Clinton,1998,10,34,yes,33.666666666666664
65,31,3,William J. Clinton,1998,10,34,yes,33.666666666666664
65,31,3,William J. Clinton,1998,10,34,yes,33.666666666666664
63,33,3,William J. Clinton,1998,10,30,yes,33.666666666666664
63,33,3,William J. Clinton,1998,10,30,yes,33.666666666666664
57,34,7,William J. Clinton,1996,11,23,yes,21.666666666666668
57,34,7,William J. Clinton,1996,11,23,yes,21.666666666666668
54,36,9,William J. Clinton,1996,10,18,yes,21.666666666666668
54,36,9,William J. Clinton,1996,10,18,yes,21.666666666666668
58,34,8,William J. Clinton,1996,10,24,yes,21.666666666666668
58,34,8,William J. Clinton,1996,10,24,yes,21.666666666666668
43,48,7,William J. Clinton,1994,11,-5,yes,-5
43,48,7,William J. Clinton,1994,11,-5,yes,-5
45,46,7,William J. Clinton,1994,11,-1,yes,-5
45,46,7,William J. Clinton,1994,11,-1,yes,-5
47,46,5,William J. Clinton,1994,10,1,yes,-5
47,46,5,William J. Clinton,1994,10,1,yes,-5
41,52,7,William J. Clinton,1994,10,-11,yes,-5
41,52,7,William J. Clinton,1994,10,-11,yes,-5
42,51,5,William J. Clinton,1994,10,-9,yes,-5
42,51,5,William J. Clinton,1994,10,-9,yes,-5
42,46,11,George Bush,1992,11,-4,yes,-17.5
42,46,11,George Bush,1992,11,-4,yes,-17.5
42,46,11,George Bush,1992,11,-4,yes,-17.5
42,46,11,George Bush,1992,11,-4,yes,-17.5
37,58,4,George Bush,1992,10,-21,yes,-17.5
37,58,4,George Bush,1992,10,-21,yes,-17.5
34,56,9,George Bush,1992,10,-22,yes,-17.5
34,56,9,George Bush,1992,10,-22,yes,-17.5
33,57,8,George Bush,1992,10,-24,yes,-17.5
33,57,8,George Bush,1992,10,-24,yes,-17.5
29,59,10,George Bush,1992,10,-30,yes,-17.5
29,59,10,George Bush,1992,10,-30,yes,-17.5
54,32,13,George Bush,1990,11,22,yes,25.3
58,32,8,George Bush,1990,11,26,yes,25.3
54,32,13,George Bush,1990,11,22,yes,25.3
58,32,8,George Bush,1990,11,26,yes,25.3
51,36,12,George Bush,1990,11,15,yes,25.3
51,36,12,George Bush,1990,11,15,yes,25.3
57,33,8,George Bush,1990,11,24,yes,25.3
57,33,8,George Bush,1990,11,24,yes,25.3
54,35,10,George Bush,1990,10,19,yes,25.3
54,35,10,George Bush,1990,10,19,yes,25.3
52,36,10,George Bush,1990,10,16,yes,25.3
56,32,10,George Bush,1990,10,24,yes,25.3
52,36,10,George Bush,1990,10,16,yes,25.3
56,32,10,George Bush,1990,10,24,yes,25.3
56,33,10,George Bush,1990,10,23,yes,25.3
56,33,10,George Bush,1990,10,23,yes,25.3
65,25,9,George Bush,1990,10,40,yes,25.3
65,25,9,George Bush,1990,10,40,yes,25.3
66,22,11,George Bush,1990,10,44,yes,25.3
66,22,11,George Bush,1990,10,44,yes,25.3
56,35,8,Ronald Reagan,1988,11,21,yes,21
56,35,8,Ronald Reagan,1988,11,21,yes,21
64,28,7,Ronald Reagan,1986,10,36,yes,36
64,28,7,Ronald Reagan,1986,10,36,yes,36
61,30,8,Ronald Reagan,1984,11,31,yes,25
61,30,8,Ronald Reagan,1984,11,31,yes,25
58,32,8,Ronald Reagan,1984,10,26,yes,25
58,32,8,Ronald Reagan,1984,10,26,yes,25
53,35,10,Ronald Reagan,1984,10,18,yes,25
53,35,10,Ronald Reagan,1984,10,18,yes,25
43,46,9,Ronald Reagan,1982,11,-3,yes,-4.666666666666667
43,46,9,Ronald Reagan,1982,11,-3,yes,-4.666666666666667
42,47,10,Ronald Reagan,1982,11,-5,yes,-4.666666666666667
42,47,10,Ronald Reagan,1982,11,-5,yes,-4.666666666666667
41,47,10,Ronald Reagan,1982,10,-6,yes,-4.666666666666667
41,47,10,Ronald Reagan,1982,10,-6,yes,-4.666666666666667
31,56,12,Jimmy Carter,1980,11,-25,yes,-25
31,56,12,Jimmy Carter,1980,11,-25,yes,-25
50,33,16,Jimmy Carter,1978,11,17,yes,15
50,33,16,Jimmy Carter,1978,11,17,yes,15
49,36,14,Jimmy Carter,1978,10,13,yes,15
49,36,14,Jimmy Carter,1978,10,13,yes,15
48,31,20,Gerald R. Ford,1974,11,17,yes,20
48,31,20,Gerald R. Ford,1974,11,17,yes,20
47,33,19,Gerald R. Ford,1974,11,14,yes,20
47,33,19,Gerald R. Ford,1974,11,14,yes,20
53,28,17,Gerald R. Ford,1974,10,25,yes,20
53,28,17,Gerald R. Ford,1974,10,25,yes,20
52,28,19,Gerald R. Ford,1974,10,24,yes,20
52,28,19,Gerald R. Ford,1974,10,24,yes,20
62,28,9,Richard Nixon,1972,11,34,yes,34
62,28,9,Richard Nixon,1972,11,34,yes,34
56,29,13,Richard Nixon,1970,11,27,yes,28.5
56,29,13,Richard Nixon,1970,11,27,yes,28.5
57,27,14,Richard Nixon,1970,10,30,yes,28.5
57,27,14,Richard Nixon,1970,10,30,yes,28.5
43,44,12,Lyndon B. Johnson,1968,11,-1,yes,-5
43,44,12,Lyndon B. Johnson,1968,11,-1,yes,-5
41,50,7,Lyndon B. Johnson,1968,10,-9,yes,-5
41,50,7,Lyndon B. Johnson,1968,10,-9,yes,-5
48,35,16,Lyndon B. Johnson,1966,11,13,yes,6.666666666666667
48,35,16,Lyndon B. Johnson,1966,11,13,yes,6.666666666666667
44,40,14,Lyndon B. Johnson,1966,10,4,yes,6.666666666666667
44,40,14,Lyndon B. Johnson,1966,10,4,yes,6.666666666666667
44,41,13,Lyndon B. Johnson,1966,10,3,yes,6.666666666666667
44,41,13,Lyndon B. Johnson,1966,10,3,yes,6.666666666666667
68,18,13,Lyndon B. Johnson,1964,11,50,yes,50
68,18,13,Lyndon B. Johnson,1964,11,50,yes,50
72,13,13,John F. Kennedy,1962,11,59,yes,47.5
72,13,13,John F. Kennedy,1962,11,59,yes,47.5
60,24,14,John F. Kennedy,1962,10,36,yes,47.5
60,24,14,John F. Kennedy,1962,10,36,yes,47.5
59,25,14,Dwight D. Eisenhower,1960,11,34,yes,30
59,25,14,Dwight D. Eisenhower,1960,11,34,yes,30
57,31,10,Dwight D. Eisenhower,1960,10,26,yes,30
57,31,10,Dwight D. Eisenhower,1960,10,26,yes,30
51,29,18,Dwight D. Eisenhower,1958,11,22,yes,26
51,29,18,Dwight D. Eisenhower,1958,11,22,yes,26
56,26,16,Dwight D. Eisenhower,1958,10,30,yes,26
56,26,16,Dwight D. Eisenhower,1958,10,30,yes,26
74,14,10,Dwight D. Eisenhower,1956,11,60,yes,60
74,14,10,Dwight D. Eisenhower,1956,11,60,yes,60
68,23,7,Dwight D. Eisenhower,1954,11,45,yes,38.333333333333336
68,23,7,Dwight D. Eisenhower,1954,11,45,yes,38.333333333333336
57,23,18,Dwight D. Eisenhower,1954,11,34,yes,38.333333333333336
57,23,18,Dwight D. Eisenhower,1954,11,34,yes,38.333333333333336
61,25,12,Dwight D. Eisenhower,1954,10,36,yes,38.333333333333336
61,25,12,Dwight D. Eisenhower,1954,10,36,yes,38.333333333333336
32,55,11,Harry S. Truman,1952,10,-23,yes,-23.666666666666668
32,55,11,Harry S. Truman,1952,10,-23,yes,-23.666666666666668
30,56,11,Harry S. Truman,1952,10,-26,yes,-23.666666666666668
30,56,11,Harry S. Truman,1952,10,-26,yes,-23.666666666666668
32,54,11,Harry S. Truman,1952,10,-22,yes,-23.666666666666668
32,54,11,Harry S. Truman,1952,10,-22,yes,-23.666666666666668
40,45,13,Harry S. Truman,1950,10,-5,yes,-3.666666666666667
40,45,13,Harry S. Truman,1950,10,-5,yes,-3.666666666666667
36,48,14,Harry S. Truman,1950,10,-12,yes,-3.666666666666667
36,48,14,Harry S. Truman,1950,10,-12,yes,-3.666666666666667
42,36,21,Harry S. Truman,1950,10,6,yes,-3.666666666666667
42,36,21,Harry S. Truman,1950,10,6,yes,-3.666666666666667
34,52,13,Harry S. Truman,1946,11,-18,yes,-23.5
34,52,13,Harry S. Truman,1946,11,-18,yes,-23.5
27,56,16,Harry S. Truman,1946,10,-29,yes,-23.5
27,56,16,Harry S. Truman,1946,10,-29,yes,-23.5
